# This puzzle is solvable
12
  1   4  89 128  43 114  88  86  14  57 133  13
106  79   2   6 139 105  54  50 140  91  12  55
 80  15  47  49  85  70  48 142  10  17 143  53
104 107  75  45 131 112  77 141  16  18  24  92
127 125   3 136  82  84  61  97  11 129  25 132
109  40 120  38 126 102  81  20   8  60 113   7
130  37  44 110  83  46 111  52  90  96  95  19
138 115  36  94  51  31  27  58 124   9 123 103
 41  29  74 108  68  56 100 134 121  67 117  63
135  66  73   5  78  30  34  71  23  65  62  22
 35  76  99   0 122  72  28 119  39  42  64  21
 32  69 101  33  26 137  59 116 118  93  87  98
