# This puzzle is solvable
12
 46  79 142  84 139  81  83 111   9  55  14  10
 50 107   2 120 131   7 133 128  88  11 114  44
 48  78   6   1   5 143  85  66   8 115  12  86
104 127   3 110 132 106  37 118  82  91  49 117
 75  43 108  42 129  47 112  35 113  52  56  87
123  45 105  31  29  40  71 109 130  58 122  13
  4  38 101 141  26  53 100  54  95 140  51  15
 39  89  30  19  57  27  67 125  22  59  69 116
 33 126  41  28 124  32 102  17  97 137  18  21
 94  77  34  93 136  80  61  92 134  63  60  20
 68  72  70 121  74   0  90 119  65  16  23  96
103 138  36  76  99 135  62  73  64  98  25  24
