# This puzzle is solvable
17
 65   3   7  68   1 123   5  69   6 131  10  16  11  81  13  18 133
 61 167 208 120 125   2  72   8 246 242   4  14 177  15  21  76  80
 64 207 121 172 212 166 267  71 214  74 210  12 130  75  82  22  79
239 119 241 164  70 170 124 180 213  67 132 248 216 181  20 135  78
118 280  62 122  63 128 286 262 274 268 251 269 281 215  77 182  25
205 287 211 169 243 175  54 114 117 178 174 163 171  17  19 218 137
200 165 160 263 202  66 206 237 273 173 288 270 179 244 129 136  84
 59 168 209 240 150 236 245 115 126 276 220 176 266 223 134  26  86
  0  58 277  60 204 231 247 228 238  73 184 127 219  23 222 186 139
 57 162 158 112 279 283 258 232 254   9 264  24 265 252 284  87  89
235 116 110 199 203 278 282 271 275 153 250 227 253 256  83 217 183
 55  48 261 201  56 159 151 260 272 140 192 141 138  29 190 188  90
 53 161 155 107 257 111 104 255 249 100 259 185 226 221 142  94  85
198 154 195 108 194  43 105 103  41 187 285  28 148 145  27  91 147
152 157 109 113 156 233  44 196 191  40 146  97  34  30 225  88  92
 47  46  50  51  45 229 102  99  38  98  93  95  31 149 189  32  35
 52 106 193  49 234 197 230 101  42  39 224 144  96  37 143  33  36
