# This puzzle is solvable
17
 65   4   2  64 239  68 173 210 128 124  17 268 218 216  14  74 177
 66   3 208 122  69 129   5  10  77 179  76 214 246 174 132  80  79
120 212 119   1 172  67  70  85 206 284  75  83  78  15 139 256  81
 63  62 121 125 245  11 213   6 219 130  71 249 267 150  18  19 220
117  61 118 123 209 279   7 191  82 171 215 217  22 181  13 185  25
 60 202 116 207 237  12   9  73 205 241 270 126  72 134   8 183 136
114 166 235 240 168 286 211 162 263 247 269 182 250  20  23  88   0
109 163  57 261 170 169 266 138 176 254 244 131  26  16  21  24 222
165 164 115  59 281 280 204 175 278 242 133 283 253 137 288 135  28
 58 113 110 112 265 236 203 167 127 180 224 271 227 178  87 184 142
158 161 160 287 198 262 264 248 140 275 225 285 273 186 188 252 144
157 106  53 238 156 200 197 195 272 221 194  97 251  98 187  27 141
 54  51  55  56 232 234 276 282  42 100  95 148 277 145  84 223  89
201 107 102  45 199 154 230 193 274  99 258 190  92 229  86  93  30
 50 155  49  43 233  46 101 228 152 243  96 231 147  34  33 146  90
 47  52 260  48 105 259 196 153 255 149 189  39 192  31 143  35  91
108 111 104 159 257  44  41 226 103 151  40  38  36  94  32  29  37
