# This puzzle is unsolvable
12
 42  40  82  11   1   7  53 131  15 137 143 115
110  50  41  72 129   5  87 135  94 114 112  10
 77  84  46 130 105  39  14  88  47   4  12  83
 52   3  45  54  78 142  96  85 138 132  91  56
  9  48 104   0  74  44 141 108  61  13  89 117
 43  31  75 121  76  90 136  79 139  16  17  67
 36  73 127 123 106  60 128   6  18  86  58  49
109  38 134 133 118  66  27 120  19  24 113  63
 80 124  81  68  98 140 126  55  71  57  62   8
103  69 102 101  95 100  26  29 122  92  59  51
 28  32  34 107  30  97  65  70  93   2  21  20
 35  99  33 116  37 111  23 119  25  64  22 125
