# This puzzle is unsolvable
12
 83 124 108   8   9 129  82   1  84  11 136  90
107  45  42  49 117 112 127  78  52 114 113  25
103   5 125   7 132   2  81  85  53 133  13  48
141 122  37 104 128  80  57  41  61  89  88  87
 44  36  77 140   3   6  35  10  20  12  23  47
 43  51  38  68 110  92 130  54  46 138 106 116
 39 139 134 126 121  28   4 123  16  55  19  58
 69  40  70  96  94 131  56  98  76  17  14  50
 74 105  75  79  30  26 109 118  66  60  86  22
 71  73 111  24  95 102  62 135 115  67  91  15
 97  99  31  64  34   0  93  27  21  72  63 142
 32  33  29 119 143 101  59 100 137  18  65 120
