# This puzzle is unsolvable
17
 64  63   1 168   5 170 120  73  10 128  11  15   8  12  16 133  19
 66  65 166   2 127   7   6  69  74  71 217  76   9  18  78 178  20
121   3 173  67 265 126 246  68 213 266  70 130  79 132 177  14  81
 59  61 239 206  62 122 172 125  75 174 140 180 216 131 134  77  80
  0 117 171 167 175 169 212 214 275 269 218 245 267 136 248 249 181
 60 241 276 243 119   4 234 124 278 273 281 285  13  21 188 135  82
164  58 207 209 242 123  72 211 208 244 205 182 137  22  23  17  90
240  57 165 116 268 237 282 260 203 221 270 129 183  92 222  85  83
115 162 118 204  52 215 280 256 236 187 287 223 247  26 138  24  84
113 112  54 210 161 262 288 264 279 263 227  35 286 283  87  86 179
238  55 159 259 202 274  37 195 232 185 141 148 176 254  28 189 186
 56 156 114 200 201  43 255 231 220 150  25 284 142 102 224 143  27
163 196 105 111 153 228 261 155 149  47 184  91 225  29 146 251 147
160 235 277 258 151  46 226 272  39  99  96  38 190  31 191  95  30
154  51  45  48 158  42 110 252 253 230 194 152 229  94 271  33  32
233 109 199 108  49  44 198  41  98 257  36 250  34 192 139 219  89
 50 101 157 107  53 197 104 106 100 103 145  40 193  97  93 144  88
