# This puzzle is unsolvable
17
  2 123   1 240 121  65 129 177 216  76  14  78  74 131  17  16  19
166  69 207 244   4 282   9 172  73 167 247 219 182 127 133  18  15
119  70 208 169 118 128  77   6 245 210   5  75 246 185 130 218  79
116  66 115  71  11  58 278 242   8  10  12 179 136  80 140 180 132
 62  61 243   3   0 122  68 174 211 176 175  85 215 178  81  84  20
120 236 125  57  67 206 217 213 270  22 267 181 184 283  21 183  24
 63 165 170  59 212 204 269 241 284 126 135 266  13 134  83  86 137
163 281 171 114   7 214 203 275 124 252 271  88 173 249  82  26  23
 64 209 117 263 264 238 286 259 268  72 272 186 251 138 187 141 225
168 237 205 164 239  60 162  43 255 262 265 248 285 220 224 139  31
202  53 113  56 235 200 152 287 195 274 231 256 229 273  25 143  27
 50  55 108 193 277 161 199 228 288 279 250 221 149  91 227 189  97
158 112 109 198  54 201 155 157 151 230 260 192 105  90 144 146  87
160 106 257  46 196  49 153 190 253 101 142 188 226 254  89 222  29
107  52 276 261 159 234  35 197  98  40 233  92  99  41  28  32  34
156 258  51 232  47 280  39 150 148 154 223 147 194  36  94  30 191
111 110  48  42 103 104 102  96 100  44 145  45  95  38  33  37  93
